wwwwwwwwwwwwwwwwwwwwwwwww
wP.W.b.W.b.W.b.W.b.W.b.Pw
w.b.W.b.W.b.W.b.W.b.W.b.w
wW.b.W.b.W.b.W.b.W.b.W.bw
w.W.b.W.b.W.b.W.b.W.b.W.w
wb.W.b.W.b.W.b.W.b.W.b.Ww
w.b.W.b.W.b.W.b.W.b.W.b.w
wW.b.W.b.W.b.W.b.W.b.W.bw
w.W.b.W.b.W.b.W.b.W.b.W.w
wb.W.b.W.b.W.b.W.b.W.b.Ww
w.b.W.b.W.b.W.b.W.b.W.b.w
wW.b.W.b.W.b.W.b.W.b.W.bw
w.W.b.W.b.W.P.W.b.W.b.W.w
wb.W.b.W.b.W.b.W.b.W.b.Ww
w.b.W.b.W.b.W.b.W.b.W.b.w
wW.b.W.b.W.b.W.b.W.b.W.bw
w.W.b.W.b.W.b.W.b.W.b.W.w
wb.W.b.W.b.W.b.W.b.W.b.Ww
w.b.W.b.W.b.W.b.W.b.W.b.w
wW.b.W.b.W.b.W.b.W.b.W.bw
w.W.b.W.b.W.b.W.b.W.b.W.w
wb.W.b.W.b.W.b.W.b.W.b.Ww
w.b.W.b.W.b.W.b.W.b.W.b.w
wP.b.W.b.W.b.W.b.W.b.W.Pw
wwwwwwwwwwwwwwwwwwwwwwwww
