wwwwwwwwwwwwwwwwwwwwwwwwwwwwwwwwwwwwwwwww
wP.b.b.b.b.b.b.b.b.b.b.b.b.b.b.b.b.b.b.Pw
w.b.b.b.b.b.b.b.b.b.b.b.b.b.b.b.b.b.b.b.w
wb.b.b.b.b.wwwwwbw.b.wbw.bwwww.b.b.b.b.bw
w.b.b.b.b.b.bw.b.wb.bw.wbw.b.b.b.b.b.b.bw
w.b.b.b.b.b.bw.b.wwwwwbw.bwww.b.b.b.b.b.w
wb.b.b.b.b.b.wb.bw.b.wbw.b.b.wb.b.b.b.b.w
wb.b.b.b.b.b.wb.bw.b.wbw.wwwwb.b.b.b.b.bw
w.b.b.b.b.b.b.b.b.b.b.b.b.b.b.b.b.b.b.b.w
wb.b.b.b.b.b.b.b.b.b.b.b.b.b.b.b.b.b.b.bw
w.b.b.b.b.b.b.b.bw.bwwww.b.b.b.b.b.b.b.bw
w.b.b.b.b.b.b.b.bw.wb.b.b.b.b.b.b.b.b.b.w
wb.b.b.b.b.b.b.b.wb.wwwb.b.b.b.b.b.b.b.bw
w.b.b.b.b.b.b.b.bw.b.b.wb.b.b.b.b.b.b.b.w
wb.b.b.b.b.b.b.b.wbwwww.b.b.b.b.b.b.b.b.w
wb.b.b.b.b.b.b.b.b.b.b.b.b.b.b.b.b.b.b.bw
w.b.b.b.b.b.b.b.b.b.b.b.b.b.b.b.b.b.b.b.w
wbwwwww.wwwwwbw.wwwwwbwwwww.bwwww.wb.bw.w
wbw.b.b.w...wbw.b.wb.bw.b.b.wb.b.bw.b.wbw
w.wwwb.bwwwww.wb.bw.b.wwwb.bw.b.b.wwwwwbw
w.wb.b.bw.b.b.wb.bw.b.wb.b.bw.b.b.wb.bw.w
wbwwwww.wb.b.bw.b.wb.bwwwww.bwwww.wb.bw.w
w.b.b.b.b.b.b.b.b.b.b.b.b.b.b.b.b.b.b.b.w
wP..b.b.b.b.b.b.b.b.b.b.b.b.b.b.b.b.b..Pw
wwwwwwwwwwwwwwwwwwwwwwwwwwwwwwwwwwwwwwwww
